1111111111111
10C1000000001
1000011111101
1P0E110000001
1111111111111