111111111111111111111
1001C000000C111111111
100001111101111111111
1P00110E0000111111111
111111111111111111111