1111111111111
10C1000000001
1000010111111
1P0111E000001
1111111111111