1111111111111
10011C000C001
10E00C1111001
1PC0111000001
1111111111111
