11111111111
10010001111
1111P00EC11
10110101111
10010100101
11111100001
11111101111
10000000011
11111111111