11111111111
10000000001
10C00000001
10000000001
1001C100P01
1C10110C001
11111101111
1000000EC11
11111111111