11111111111
1001E001111
11110000P11
10110100111
1001C100101
11111100001
11111101111
10000000011
11111111111