11111111111
10000000111
1010000EC11
10000000111
10011100P01
11111100001
11111101111
10000000011
11111111111