



111111111111111
100100000000111
10000111110C111
1P00110E0000111
111111111111111
