111111111
110000001
100110111
11P10E1C1
100100111
111111111