11111111111111
1000000CP00001
1000000000CC01
10000001000001
10000000000001
100000CCC00001
10000ECCC00001
111000CCC00C01
10000000000001
11111111111111
