11111111111
10010001111
1111P01EC11
10110001001
10010100101
11111100001
11111101111
10000000011
11111111111
10000000001
11111111111